https://www.youtube.com/watch?v=EgCw3OdCIbY
=====================================
Outline:
	1. top(hair) - gratitude gorilla
	2. Nose - self-aware hare
	3. Mouth - accountable ant
	4. Ear - optimistic otter
	5. Throat -  empathy elephant
	6. Shoulder - kindness kudu
	7. Collar - tenacious termites
	8. Fingers - curiosity crane
	9. Belly - patience pig
	10. Bottom - conviction cockroach
	11. Thigh - humble hummingbird
	12. knees -  ambitious angel
	
=====================================
Vocab:
	entwine: cuon vao nhau
	proven way:theo cach da duoc chung minh 
	auditory : thinh giac
	gratitude: long biet on  
	accountable: chiu trach nhiem 
	optimistic: lac quan 
	optimistic  otter: nhai ca 
	empathy: dong cam 
	cultivate: cay cay 
	kind kudu:linh duong
	termites: con moi 
	tenacious: ngoan cuong 
	curiosity: to mo
	crane: chim hac
	playful: nghich nghom
	cockroach: con gian 
	conviction: buộc tội ai đó.
	humble: khiem ton 
	hummingbird: chim ruoi
	alliteration: phep lap tui
	elephant is wrapping a trunk around the throat my be like scarf
	the elephant is so empathetic, it show you empathy 
	ambitious angel: tham vong 